NO test.png
SO test.png
WE test.png
EA test.png

C 164, 1,      2
F 164, 1,      2

111111111111111111111
101000001000000000001
101010101011111110001
100010100010000010001
111110101111101011101
100000101000101000001
101111101011101111111
101000001010100000101
101011111010111110101
101010001010100010101
101110101010101010101
100000101011111111111
11111000101111111011111111
11113111111111111311
1000000001111111111111111111
113111111111111111111
100000101000100010001
101110101110101110111
101000100000100010101
101011111111111010101
100010000000000010001
101010111011111311101
10100000N000000000001
111111111111111111111

