NO test.png
SO test.png
WE test.png
EA test.png

C 1 , 1 ,  12
                F 164 , 1,0

        111111111111111111111
        101000001000000000001
        101010101011111110001
        100010100010000010001111111111111111111111
        111110101111101011101
        100000101000101000001
        101111101011101111111               
        101000001010100000101               
        101011111010111110101               
        101010001010100010101
        101110101010101010101
        100000101011111111111
111111111111111000101111111011111111
1000000011111101111111111111111111
111111111000000001111111111111111111
        110111111111111111111
        1000001011 10100010001
        101110101110101110111
        101000100000100010101
        101011111111111010101
        100010000010100010001
        101010111010111110111
        101000000000N00000001
        111111111111111111111
11111
10001
11111