NO test.png
SO test1.png
WE test.png
EA test1.png

F 220,120,0
C 225,30,66

111111111111111111111111111111111111111111111111111111111111111111111
100000000000000000000000000000000000000000000000000000000000000000001
101111111111111111111111111111111111111111111111111111111111111111101
101000000000000000000000000000000000000000000000000000000000000000101
101011111111111111111111111111111111111111111111111111111111111110101
101000000000000000000000000000000000000000000000000000000000000000101
101111111111111111111111111111111111111111111111111111111111111111101
100000000000000000000000000000000000000000000000000000000000000000001
111111111111111111111111111111111111111111111111111111111111111111101
100000000000000000000000000000000000000000000000000000000000000000101
101111111111111111111111111111111111111111111111111111111111111110101
101000000000000000000000000000000000000000000000000000000000000000101
101011111111111111111111111111111111111111111111111111111111111111101
101000000000000000000000000000000000000000000000000000000000000000001
101111111111111111111111111111111111111111111111111111111111111111101
100000000000000000000000000000000000000000000000000000000000000000001
101111111111111111111111111111111111111111111111111111111111111110101
101000000000000000000000000000000000000000000000000000000000000000101
101011111111111111111111111111111111111111111111111111111111111111101
101000000000000000000000000000000000000000000000000000000000000000001
101111111111111111111111111111111111111111111111111111111111111111111
100000000000000000000000000000000000000000000000000000000000000000001
111111111111111111111111111111111111111111111111111111111111111111111
100000000000000000000000000000000000000000000000000000000000000000001
101111111111111111111111111111111111111111111111111111111111111111101
101000000000000000000000000000000000000000000000000000000000000000101
101011111111111111111111111111111111111111111111111111111111111110101
101000000000000000000000000000000000000000000000000000000000000000101
101111111111111111111111111111111111111111111111111111111111111111101
100000000000000000000000000000000000000000000000000000000000000000001
111111111111111111111111111111111111111111111111111111111111111111101
100000000000000000000000000000000000000000000000000000000000000000101
101111111111111111111111111111111111111111111111111111111111111110101
101000000000000000000000000000000000000000000000000000000000000000101
101011111111111111111111111111111111111111111111111111111111111111101
101000000000000000000000000000000000000000000000000000000000000000001
101111111111111111111111111111111111111111111111111111111111111111101
100000000000000000000000000000000000000000000000000000000000000000001
101111111111111111111111111111111111111111111111111111111111111110101
101000000000000000000000000000000000000000000000000000000000000000101
101000000000000000000000000000000000000000000000000000000000000000101
101011111111111111111111111111111111111111111111111111111111111111101
101000000000000000000000000000000000000000000000000000000000000000001
101111111111111111111111111111111111111111111111111111111111111111101
100000000000000000000000000000000000000000000000000000000000000000001
101111111111111111111111111111111111111111111111111111111111111110101
101000000000000000000000000000000000000000000000000000000000000000101
101000000000000000000000000000000000000000000000000000000000000000101
101011111111111111111111111111111111111111111111111111111111111111101
101000000000000000000000000000000000000000000000000000000000000000001
101111111111111111111111111111111111111111111111111111111111111111101
100000000000000000000000000000000000000000000000000000000000000000001
101111111111111111111111111111111111111111111111111111111111111110101
101000000000000000000000000000000000000000000000000000000000000000101
101000000000000000000000000000000000000000000000000000000000000000101
101011111111111111111111111111111111111111111111111111111111111111101
101000000000000000000000000000000000000000000000000000000000000000001
101111111111111111111111111111111111111111111111111111111111111111101
100000000000000000000000000000000000000000000000000000000000000000001
101111111111111111111111111111111111111111111111111111111111111110101
101000000000000000000000000000000000000000000000000000000000000000101
101000000000000000000000000000000000000000000000000000000000000000101
101011111111111111111111111111111111111111111111111111111111111111101
101000000000000000000000000000000000000000000000000000000000000000001
101111111111111111111111111111111111111111111111111111111111111111101
100000000000000000000000000000000000000000000000000000000000000000001
101111111111111111111111111111111111111111111111111111111111111110101
101000000000000000000000000000000000000000000000000000000000000000101
101000000000000000000000000000000000000000000000000000000000000000101
101011111111111111111111111111111111111111111111111111111111111111101
101000000000000000000000000000000000000000000000000000000000000000001
101111111111111111111111111111111111111111111111113111111111111111101
100000000000000000000000000000000000000000000000000000000000000000001
101111111111111111111111111111111111111111111111111111111111111110101
101000000000000000000000000000000000000000000000000000000000000000101
101000000000000000000000000000000000000000000000000000000000000000101
101011111111111111111111111111111111111111111111111111111111111111101
101000000000000000000000000000000000000000000000000000000000000000001
101111111111111111111111111111111111111111111111111111111111111111101
100000000000000000000000000000000000000000000000000000000000000000001
101111111111111111111111111111111111111111111111111111111111111110101
101000000000000000000000000000000000000000000000000000000000000000101
101000000000000000000000000000000000000000000000000000000000000000101
101011111111111111111111111111111111111111111111111111111111111111101
101000000000000000000000000000000000000000000000000000000000000000001
101111111111111111111111111111111111111111111111111111111111111111101
100000000000000000000000000000000000000000000000000000000000000000001
101111111111111111111111111111111111111111111111111111111111111110101
101000000000000000000000000000000000000000000000000000000000000000101
101000000000000000000000000000000000000000000000000000000000000000101
101011111111111111111111111111111111111111111111111111111111111111101
101000000000000000000000000000000000000000000000000000000000000000001
101111111111111111111111111111111111111111111111111111111111111111101
100000000000000000000000000000000000000000000000000000000000000000001
101111111111111111111111111111111111111111111111111111111111111110101
101000000000000000000000000000000000000000000000000000000000000000101
101000000000000000000000000000000000000000000000000000000000000000101
101011111111111111111111111111111111111111111111111111111111111111101
101000000000000000000000000000000000000000000000000000000000000000001
101111111111111111111111111111111111111111111111111111111111111111101
100000000000000000000000000000000000000000000000000000000000000000001
101111111111111111111111111111111111111111111111111111111111111110101
101000000000000000000000000000000000000000000000000000000000000000101
101011111111111111111111111111111111111111111111111111111111111111101
101000000000000000000000000000000000000000000000000000000000000000001
101111111111111111111111111111111111111111311111111113111111311111111
1000000000000000000000000000000000000000000000000000000000000000000N1
111111111111111111111111111111111111111111111111111111111111111111111
