NO test.png
SO test.png
WE test.png
EA test.png

F 220,100,0
C 225,30,0

11111111111111111111111111
1000000000110000000000001
1011000001110000000000001
100100000000000000000000111111111
111111111011000001110000000000001
10000000011000001110111111111111
11110111111111011100000010001111
1111011111111111101010010001111
11000000110101  110111000000101
10000S0000000111110001000111111
100000000000000110101001000111
1100000111010101111101111000111
11110111111010110111101000111
111111111111111111111111111
