NO test.png
SO test.png
WE test.png
EA test.png

F 220,100,0
C 225,30,0

11111111111111111111111111
1000000000110000000000001
1011000001110000000000001
100100000000000000000000111111111
111111111011000001110000000000001
100000000011000001110111111111111
11110111111111011100000010001
11110111111111011101010010001111
11000000110101   011100000010001
10000000000000001100000010001111
10000000W00000001101010010001
1100000111010101111101111000111
11110111111010110111101000111
111111111111111111111111111
