NO test.png 
SO test.png

F 20,            25    ,20 
WE test.png

C 200,  200,   20
EA test.png

111    
111
101
101
101
 111
111   111111       
1111   10001
101    11111
101
111
101
101
101
101
111



