   WE                            test.png
NO      test.png



SO test.png

F      17,    38,     64

EA test.png



C 218, 234, 235

1111111111111
10S0100000001
1000111111001
1000110001001
1000000001001
1111111111111
