NO wall_image/test.png
SO wall_image/test.png
WE wall_image/test.png
EA wall_image/test.png

C 164, 1,      2
F 164, 1,      2

111111111111111111111
101000001000000000001
101010101011111110001
100010100010000010001
111310101111101011101
100000101000101000001
101111101011101111111
101000001010100000101
101011131010113110101
101010001010100010101
101110101030301010101
100000101011111111111
111110001011111110111
11110113111111111011
100000000111111111111
110111111111111111111
100000101000100010001
11113101110101110111
101000100000100010101
101011111111111010101
100010000000000010001
101010113111111011101
10100000N000000000001
111111111111111111111

