F 76,76,76
C 99,99,99

NO wall_image/woow.png
SO wall_image/woow.png
WE wall_image/woow.png
EA wall_image/woow.png

1111111111111111111
10W1001001001000001
10110000010000010011011
100100100111110111111111
1001311000001001001
1000000000000001001
1001113111311001001
1111000000000001011
1000000001000000001
1111111111111111111

