NO wall_image/vanl.png
SO wall_image/team.png
WE wall_image/woow.png
EA wall_image/test.png

F 220,100,0
C 225,30,0

        1111111111111111111111111
        1000000000110000000000001
        1011000001110000000000001
        1001000000000000000000001
111111111011000001310000000000001
100000000000000001010111111111111
11110110111311011100000010001
11110113111011011101010010001
11000000110101011100000010001
10000000000000001100000010001
1000000000000S001101010010001
1100000111010101111101111000111
11110111 1110101 101111010001
11111111 1111111 111111111111
