C 164, 1            ,             2
NO wall_image/door.png
SO wall_image/door.png
                                                                            F 164, 1,      2
WE wall_image/door.png
EA wall_image/door.png

      11111111111111111111
     1N1000001000000000001
     101010101011111110001
     100010100010000010001
     1111101011111010111011111
 11111111110001111111111001111111
100000000000000000000000000000011
1111111000011111111111111111111111
     100000101000101000001111111
     101111101011101111111
     101000001010100000101
     101011111010111110101
     101010001010100010101
     101110101010101010101
     100000101011111111111
     111110001011111110111
     11110111111111111011
     100000000111111111111
     110111111111111111111
     100000101000100010001
     101110101110101110111
     101000100000100010101
     101011111111111010101
     100010000000000010001
     101010111011111011101
     101000000000000000001
     111111111111111111111


